NO ../inc/NO.xpm
SO ../inc/SO.xpm
WE ../inc/WE.xpm
EA ../inc/EA.xpm


F 	0,0, 255
C 0,255,0


1111111
10000W1
1000110
1111111