NO ../inc/NO.xpm
SO ../inc/SO.xpm
WE ../inc/WE.xpm
EA ../inc/EA.xpm


F 	10,100,0
C 225,30,0


1111111
10000N1
1000110
1111111