NO ./inc/NO.xpm
SO ./inc/SO.xpm
WE ./inc/WE.xpm
EA ./inc/EA.xpm


F 	255, 255, 0
C 0,0, 255


1111111
10000W1
1000110
1111111