NO ./inc/NO.xpm
SO ./inc/SO.xpm
WE ./inc/WE.xpm
EA ./inc/EA.xpm


F 	255, 255, 0
C 0,0, 255

11111111111111111111111111111111111
1W000000000000000000000100000000001
11111111111111111111110001111111111
                      111