NO ./textures/NO.xpm
SO ./textures/SO.xpm
WE ./textures/WE.xpm
EA ./textures/EA.xpm
F                 10,100,0
C             225,30,0


1111111111
1100001111
10000N0001
1001111111
1111111111